#################
#       #       #
# ##### # ##### #
#   # # #     # #
# # # # ##### # #
#   # #       # # 
### # ####### # #
#   # #    #  # # 
# ### # ## # ## #
S     # ##    # E
#################