#####################################################################################################
S #   #       #   # #       #     #             #         # #     #   #       #       #     #   #   #
# # # # ##### # # # # # ### # ##### # ########### ### ### # # # # # ### ##### # ### # # ### # # ### #
#   #   # #   # # #   # #   #     # #   #           # #     # # #   #   #   #   #   #   # # # # #   #
######### # ### # ##### # ### ### # ### # ########### # ##### # ##### ### # ##### ####### # # # # # #
#       # #     # #   # # #   # #   # #         #     # #     #   #   #   #     # #     #   # #   # #
# ##### # ####### # # # # # ### ##### ########### ####### ####### # ### # ####### # # ### ### #######
#   #   #   #   #   # # # # #   #         #   #   #     #     # # #     # #       # # #   #         #
### # ### # # # ##### # # # # # # ### ##### # # ### ### ##### # # ##### ### ######### # ### ####### #
#   #     # # #     #   # # # #   #   #     # #     #     #   # #   #   #   #   #     #   # # #     #
# ########### ##### ##### # # ##### ### ##### # ##### ### # ### ### # ### ### ### # ##### # # # ### #
#     #   #   #   #     # # #   #   #   #   # # #     #   #       # #   #   #   # #     # # # # #   #
# ### # # # ##### # ##### # ### # ### ### ### # # ############# ### ### ### # # # ##### # # # # # ###
# # #   #   #     # #     #     # #   # #     # # #   #       # #   #   # # # # # #     # #   # # # #
# # ########### # # # ########### # ### # ####### # # # ### # # # # # ### # ### # # ##### ##### # # #
#   #           # #   #   #   #   # # #   #     # # #     # # # # # #     # #   # # #   #       # # #
### ##### ####### ##### # # # # ### # # ### # # # # ####### ### # ### ##### # ### # # # ######### # #
# #       #     #   #   #   # #   # #   # # # # #       #   #   # #   #     #   # #   #         #   #
# ############# ### # ### ####### # # ### # # # ##### ### # # ### # ### ##### # # ########### ##### #
# #     #       #   # #   #       # #   #   # #     # #   # # #   # #   #     # #       #   #       #
# # ### # # ### # ### # ### ####### ### ##### ##### ### # ### # ### # ######### ####### ### #########
#   # # # # #   # #   # #   #   #   # #       #     #   # #   #     #   #           # #   #     #   #
# ### # # # # ### # ### # ### # # ### ######### ##### ##### ########### # ######### # ### # # # ### #
#     # # # # #   # #   #   # #   #           # #   # #           # #   #       #   # #   # # #     #
# ##### # # ### ### ####### # ##### ######### # # # # # ######### # # ### ##### # ### # ##### ##### #
# #     # #     #   #   #   # # #   #       # #   # #     #     #   # #   #     #     #       #   # #
# # ##### ####### # # # # ### # # # # ####### ##### ####### ### # ### ##### ##################### # #
# #     #   #   # #   #   #   #   # #       # #     #       #   # #   #   # #   #   #     #       # #
# ##### ### # # ########### ### ### ####### # # ##### ####### ##### ### # # # # # # # ### # ### # # #
# #   #   #   #     #       #   # # #   #   # #       #     #     # #   # # # # # #   #   # #   # # #
# ### # ########### # ####### ### # # # # ### ######### # ####### # # ### # # # # ##### ### # ##### #
#     #           #   #     #     #   # #     #     #   #   #   #   # #   # # # # #   # #   #   #   #
### ####### ### ######### # ##### ##### # ######### # ##### # # ##### ### # # # # # ### # ##### # ###
#   #     # #   #         # #   # #     # #       # #     #   #     #   #   # # # # #   # #   #   # #
# ### ### ### # # ##### ### # # # # ##### # ### # # ##### ####### ### # ##### # # # # ### # ####### #
#   # # # #   # #     # # # # # # # #   # #   # # #     #   #   #     # #     #   # #     # #       #
### # # # # ######### # # # # # ### # ### ##### # # ####### # # ####### # ######### ####### # # #####
#   # #     #         # #     #     # #   #     #   #     #   # #     # #   #               # #     #
# ### ####### ######### ############# # ### ####### # # ####### # ### # ### # ########### # # ##### #
#   # #   #   #       #   #   #       # #   #       # #   #     # #     #   # #     #   # # #   #   #
### # # # # ### ##### ### # # # ##### # # ####### ### ### # ##### ####### ### ##### # # # # ### # # #
# # # # # # #   #       # # # #   #   #   #     # #   # # # #   # #   #   # #       # #   #   # # # #
# # # # # # ##### ####### # # ### # ##### # ### # # ### # # ### # # # # ### ####### # ######### # # #
# # #   # #     #     #   # #   # # #     #   # # #     # #   # #   #   #           #   #       # # #
# # ##### ##### ##### # ##### # # # # ####### # ####### # ### # ################### ### # ####### ###
# # #   #     #       #     # #   #   # #   # #     #   #   # #       #   #       # # # #     # #   #
# # # # ### ######### ##### # ######### # # # ### ### ##### # ### ### # # # ##### # # # ##### # ### #
# # # #   # #     # # #   # #         # # #   # #   #     # #     #   # # # #   # # # #     #   # # #
# # # ### # # # # # # ### # ######### # # ##### ### ##### # ####### ### # # # ### # # # ####### # # #
# # #   #   # # # # #   # # #     #   # #   #   # #   #   #   #   #     # # #   # #   #       #   # #
# # ### # ### # # # ### # # # # ### ### ### # # # # ### ### ### # ####### # # # # ### ####### # ### #
#   # # # #   # #   #   # # # #     #     #   #   #   #   #     #   #   #   # #   #   #     # # #   #
# ### # ### ### ### # ### # ### ##### ########### ### ### ####### # # # ##### ##### ### # # # # # ###
#     #   #   # #   #   # #   # # #     #       #   #     #       # # #       #   #   # # # #   #   #
##### ### ### # # ##### # ### # # # ### # ### # ### ####### ##### ### ########### ### # # ######### #
# #     #     # # #   # #   # # #     # # #   #   #   #     #     #   #       #   #   # #         # #
# # ####### ### ### # # ### # # ####### # # ### ##### # ### ####### ####### # # ### ######### # ### #
#   #     # #   #   #   #   # #       #   # #   #   # # #   #     #   #     # #   #   #       # #   #
# ### ### ### # # ####### # # ####### ##### ##### # # # ##### ### ### # ##### # # ### # ####### # ###
# #   #       # #   #     # #   #   # #   # #     # # # #       # #   # # #   # #   #   #       #   #
# # ############### # ### # ### # # # # # # # ##### # # # ####### # ### # # ####### ##### ####### # #
# #             #   # #   #   # # #     #   # #     # #   #   #   #     #   #     # #     #     # # #
# ############# # ##### ####### ##### ####### # # ### ####### # ######### ### ### # # ##### ### # # #
# # #           #     # #   #   #   # #   #   # # #   #     # # #       # #     #   # #   #   # # # #
# # # # ############# # # # # ### # ### # # ### ### ### ### # # # ##### # # ### # ### # # ### # # # #
#   # # #         #   #   # #     #   # #   # #   #     # #   #     #   # #   # # #   # # #   # # # #
### # ### ####### # ####### ######### # ##### ### ####### # ######### # # ### # ### ##### # ### ### #
# # # #   #     # # #       #   #     #     #   #   #     # #         # #   # #     #     # # #     #
# # # # ### ### # # # ##### ### # ######### # # ### # ### # # ######### ### # ######### # # # ##### #
#   #   #   #   # # # #   #     #   #     #   # # #   # #   # #     #   #   # #         # # # #     #
# ####### ### ### # # # # ##### ### # # ####### # ##### ##### # ### # ### ### ### ####### # # # #####
# #   #   #   # #   # # #   #   # # # # #     # #       #   # #   # # # # #       #     # # #   #   #
# # # # ### ### ##### # ### # ### # # # # ### # # ##### # # # ### # # # # ##### ### ### # # # ### # #
#   #   # #     #     #   # #     #   # #   #   # #   # # #     # # #   #   # # #   #   # # # #   # #
######### ##### # ####### ####### ##### ### ##### # # # # ####### # ####### # # # ### ##### # ##### #
# #       #     #   #   #       # #   #   #   #   # #   #   #     #   #     #   # # # #     #     # #
# # ### ### ##### # # # # # ##### ### ### ### ##### # ##### # ####### # ######### # # ### ####### # #
#   # #   #   #   # # # # #     #       #   #       # #     #       #   #         # #     # #     # #
# ### ### ### ##### # # # ##### ####### # ########### # ########### ######### ##### ####### # ##### #
# #   #     #     #   # # #   #   #     #           # #   #     #   #       # #       #     # #   # #
# # # # ######### ##### # # # # ### ############# # # ### # ### # ####### # # # ### # # ### # # # # #
# # # #         #   #   # # #   #   #       # #   # #   #   #   #         # # # #   # #   #   # # # #
# # ####### # ##### # ### # ##### ##### ### # # ### ### ##### # ########### # # # ### ### ##### # # #
# # #       # #   #   #   # #     #     # #   # # # #   #     # #         #   # #   # # #       # # #
# # # # ####### # ##### ### # ##### ##### ### # # # # ### # ##### ##### ########### # # ######### # #
# # # # #       #   #   #   # #     #   #   # # #   #   # # #         #     #   #   #   #       # # #
# # # ### ####### # # ### ### ##### # # # # # # # ##### # # # ########### # # # # ####### ##### # # #
#   #   #       # # #   #   #       # #   # # # # #     # # # # #       # #   #   #       #   # #   #
### ### ####### # # ####### ######### ##### # # ### ##### # # # # ##### # ##### ### ######### # ### #
#     #   #   # # #         #     #   #     # # #   #   # # # # # #   #   # #   #   #   #     #   # #
######### # # # # ######### # # # # ### ##### # # ### # # ### # # # ####### # ### ### ### # ### ### #
#     #   # #   #   #       # # # #   # #     #   #   # #   #   # #           #   #   #   #   #     #
# ### # # # ####### ##### ### # # ### # # ######### ####### ### # ### ######### ### # # ##### #######
# # # # # # #     #     #   # # # #   #   #     #         #     #   #   #     # #   # #   #     #   #
# # # # # # # ### ##### ### # # ### ######### # ######### ##### ### ##### ### # # # ### ### ### # # #
# #     # # #   #     # #   # # #   #       # #     #     #   # #   #     #   # # #   # #   # #   # #
# ####### # ### ##### # ##### # # ### ##### # ##### # ### # # ### ### ##### ### ### # # # ### ##### #
#     #   #     #   # #     # #   #   #     # #   #   #   # #     #   #   #   #   # #   # #     #   #
# ### ########### ### ##### # ##### ### ##### # # ##### ### ####### ### # ### ### ####### # # ### ###
#   #                     #         #         # #         #             #   #             # #       E
#####################################################################################################