###################################################
S   #     #             #       #       #         #
### # ### # ### ####### ##### # ### ##### # ##### #
#   #   # #   # #     #       #   #       #   #   #
# ##### # ##### # ### ########### ##### ##### #####
# #     #       #   #       #   #     #     #     #
# # ############### ####### # ####### ##### ##### #
#   #       #     #       # #   #   # # #   #   # #
##### # ### # # # ####### # ### # # # # # ### # # #
# #   #   # # # #     #   # #   # #   # #   # # # #
# # ##### ### # ##### # ### # # # ##### ### ### # #
#     #   #   #   #   # #     # #     #   #     # #
# ##### # # ##### # ### ############# # # ### ### #
#   #   # # #     #     #         #   # #     #   #
# ### ##### # ##### ##### ##### # # ########### ###
# #   #     #   #   #     #   # # #     #     #   #
### ### ####### # ### ##### # # ####### # ### ### #
#   #   #     # # #   #     # # #   #   # # #   # #
# ### ### ### # ### ##### ### # # # # ### # ### # #
#         #   #           #   #   #       #       E
###################################################